//MAP CONVERTED BY dmm2tgm.py THIS HEADER COMMENT PREVENTS RECONVERSION, DO NOT REMOVE
"a" = (
/obj/effect/lighting_dummy/yellowlight,
/turf/simulated/sand,
/area/warfare/map)
"b" = (
/obj/hammereditor/playerclip/defuse,
/obj/effect/lighting_dummy/yellowlight,
/turf/simulated/sand,
/area/warfare/map)
"d" = (
/obj/effect/lighting_dummy/yellowlight,
/obj/item/gun/projectile/automatic/m22/combatrifle,
/obj/item/ammo_magazine/c45rifle/combatrifle,
/obj/item/ammo_magazine/c45rifle/combatrifle,
/obj/item/ammo_magazine/c45rifle/combatrifle,
/obj/item/ammo_magazine/c45rifle/combatrifle,
/turf/simulated/sand,
/area/warfare/ctspawn)
"e" = (
/obj/effect/lighting_dummy/yellowlight,
/turf/simulated/wall/perspecticrete,
/area/warfare/map)
"f" = (
/obj/effect/lighting_dummy/yellowlight,
/obj/effect/landmark{
	name = "JoinLate"
	},
/turf/simulated/sand,
/area/warfare/map)
"g" = (
/obj/effect/lighting_dummy/yellowlight,
/turf/unsimulated/floor/hammereditor/dev22,
/area/warfare/bombsite)
"h" = (
/obj/structure/ore_box,
/obj/effect/lighting_dummy/yellowlight,
/turf/simulated/sand,
/area/warfare/map)
"i" = (
/obj/structure/warfare/barricade/concrete_barrier{
	dir = 1
	},
/obj/effect/lighting_dummy/yellowlight,
/turf/simulated/sand,
/area/warfare/map)
"l" = (
/obj/structure/warfare/barricade/concrete_barrier{
	dir = 4
	},
/obj/effect/lighting_dummy/yellowlight,
/turf/simulated/sand,
/area/warfare/map)
"p" = (
/obj/effect/lighting_dummy/yellowlight,
/obj/machinery/telecomms/allinone{
	intercept = 1
	},
/turf/simulated/wall/perspecticrete,
/area/warfare/map)
"q" = (
/obj/effect/lighting_dummy/yellowlight,
/turf/unsimulated/floor/hammereditor/dev2,
/area/warfare/bombsite)
"r" = (
/obj/effect/lighting_dummy/yellowlight,
/turf/unsimulated/wall/hammereditor/dev2,
/area/space)
"s" = (
/obj/effect/lighting_dummy/yellowlight,
/obj/hammereditor/playerclip/defuse,
/turf/simulated/sand,
/area/warfare/map)
"v" = (
/obj/effect/lighting_dummy/yellowlight,
/obj/item/grenade/smokebomb,
/obj/item/grenade/smokebomb,
/obj/item/grenade/smokebomb,
/obj/item/grenade/smokebomb,
/turf/simulated/sand,
/area/warfare/tspawn)
"w" = (
/obj/effect/lighting_dummy/yellowlight,
/turf/simulated/floor/tiled/ramp{
	dir = 1
	},
/area/warfare/map)
"z" = (
/obj/effect/lighting_dummy/yellowlight,
/obj/effect/landmark/start{
	name = "Red Soldier"
	},
/turf/simulated/sand,
/area/warfare/ctspawn)
"A" = (
/obj/effect/lighting_dummy/yellowlight,
/obj/structure/effect/decal/sitemarker{
	pixel_x = 3;
	pixel_y = -14
	},
/turf/unsimulated/floor/hammereditor/dev22,
/area/warfare/bombsite)
"B" = (
/obj/effect/lighting_dummy/yellowlight,
/obj/structure/ore_box,
/turf/unsimulated/floor/hammereditor/dev22,
/area/warfare/bombsite)
"C" = (
/obj/effect/lighting_dummy/yellowlight,
/obj/effect/landmark/start{
	name = "Blurrorist"
	},
/turf/simulated/wall/perspecticrete,
/area/warfare/map)
"D" = (
/obj/effect/lighting_dummy/yellowlight,
/obj/item/gun/projectile/revolver/manual,
/obj/item/ammo_magazine/handful/revolver,
/obj/item/ammo_magazine/handful/revolver,
/obj/item/ammo_magazine/handful/revolver,
/obj/item/ammo_magazine/handful/revolver,
/turf/simulated/sand,
/area/warfare/tspawn)
"E" = (
/obj/effect/lighting_dummy/yellowlight,
/obj/effect/landmark/test/space_turf,
/turf/simulated/wall/perspecticrete,
/area/warfare/map)
"F" = (
/obj/structure/dirt_wall,
/obj/effect/lighting_dummy/yellowlight,
/turf/simulated/sand,
/area/warfare/map)
"G" = (
/obj/effect/lighting_dummy/yellowlight,
/obj/structure/ore_box,
/turf/simulated/sand,
/area/warfare/map)
"H" = (
/obj/effect/lighting_dummy/yellowlight,
/obj/structure/railing{
	dir = 8
	},
/turf/simulated/floor/tiled/ramp{
	dir = 4
	},
/area/warfare/map)
"I" = (
/obj/item/plastique/keypad/blue/defuse,
/obj/effect/lighting_dummy/yellowlight,
/turf/simulated/sand,
/area/warfare/tspawn)
"J" = (
/obj/effect/lighting_dummy/yellowlight,
/turf/simulated/floor/tiled/ramp{
	dir = 4
	},
/area/warfare/map)
"K" = (
/obj/structure/warfare/barricade/concrete_barrier,
/obj/effect/lighting_dummy/yellowlight,
/turf/simulated/sand,
/area/warfare/map)
"L" = (
/obj/effect/lighting_dummy/yellowlight,
/obj/effect/landmark{
	name = "tdome1"
	},
/turf/simulated/sand,
/area/warfare/map)
"M" = (
/obj/effect/lighting_dummy/yellowlight,
/obj/item/grenade/smokebomb,
/obj/item/grenade/smokebomb,
/turf/simulated/sand,
/area/warfare/ctspawn)
"N" = (
/obj/effect/lighting_dummy/yellowlight,
/obj/item/gun/projectile/automatic/m22/warmonger/fully_auto/nemesis,
/obj/item/ammo_magazine/c45rifle/akarabiner,
/obj/item/ammo_magazine/c45rifle/akarabiner,
/obj/item/ammo_magazine/c45rifle/akarabiner,
/obj/item/ammo_magazine/c45rifle/akarabiner,
/turf/simulated/sand,
/area/warfare/tspawn)
"O" = (
/obj/effect/lighting_dummy/yellowlight,
/obj/item/bombdefusal,
/turf/simulated/sand,
/area/warfare/ctspawn)
"P" = (
/obj/item/bombdefusal,
/obj/effect/lighting_dummy/yellowlight,
/turf/simulated/sand,
/area/warfare/ctspawn)
"Q" = (
/obj/effect/lighting_dummy/yellowlight,
/turf/simulated/floor/tiled/ramp,
/area/warfare/map)
"R" = (
/obj/effect/lighting_dummy/yellowlight,
/turf/simulated/sand,
/area/warfare/ctspawn)
"S" = (
/obj/effect/lighting_dummy/yellowlight,
/obj/effect/landmark/map_data,
/turf/simulated/wall/perspecticrete,
/area/warfare/map)
"T" = (
/obj/effect/lighting_dummy/yellowlight,
/obj/effect/landmark/start{
	name = "Blurrorist"
	},
/turf/simulated/sand,
/area/warfare/tspawn)
"U" = (
/obj/effect/lighting_dummy/yellowlight,
/turf/simulated/sand,
/area/warfare/tspawn)
"V" = (
/obj/effect/lighting_dummy/yellowlight,
/obj/structure/effect/decal/sitemarker{
	pixel_x = 0;
	pixel_y = -16
	},
/turf/unsimulated/floor/hammereditor/dev2,
/area/warfare/bombsite)
"W" = (
/obj/effect/lighting_dummy/yellowlight,
/obj/effect/landmark/test/safe_turf,
/turf/simulated/wall/perspecticrete,
/area/warfare/map)
"X" = (
/obj/structure/warfare/barricade/concrete_barrier{
	dir = 4
	},
/obj/structure/warfare/barricade/concrete_barrier,
/obj/effect/lighting_dummy/yellowlight,
/turf/simulated/sand,
/area/warfare/map)
"Z" = (
/obj/effect/lighting_dummy/yellowlight,
/obj/item/gun/projectile/revolver/manual,
/obj/item/ammo_magazine/handful/revolver,
/obj/item/ammo_magazine/handful/revolver,
/obj/item/ammo_magazine/handful/revolver,
/obj/item/ammo_magazine/handful/revolver,
/turf/simulated/sand,
/area/warfare/ctspawn)

(1,1,1) = {"
e
e
e
e
e
e
e
e
e
e
e
e
e
e
e
e
e
e
e
e
e
e
e
e
e
p
e
e
e
e
e
e
e
e
e
e
e
e
e
e
e
e
W
"}
(2,1,1) = {"
e
a
a
a
a
a
a
h
K
a
a
a
a
a
a
a
e
e
e
e
h
a
a
a
e
e
e
a
K
a
a
a
a
a
a
a
a
a
a
L
L
L
E
"}
(3,1,1) = {"
e
a
a
a
a
a
a
a
a
Q
a
a
a
a
a
a
i
a
a
a
a
a
a
a
e
e
a
a
K
a
a
a
a
a
a
a
a
a
a
L
L
L
S
"}
(4,1,1) = {"
e
h
h
a
a
a
a
a
a
Q
a
a
a
a
a
a
a
a
a
i
a
a
a
a
e
e
a
a
K
a
a
a
a
a
a
a
a
a
a
L
L
L
C
"}
(5,1,1) = {"
e
h
h
a
a
a
a
a
K
a
a
a
a
a
a
a
e
e
e
e
a
a
a
a
e
e
a
a
K
a
a
a
F
F
F
F
F
F
F
f
f
f
e
"}
(6,1,1) = {"
e
e
e
e
e
a
a
a
K
a
a
a
a
a
a
a
e
e
e
e
a
a
a
a
a
K
a
a
a
a
a
a
F
a
a
a
a
a
a
f
f
f
e
"}
(7,1,1) = {"
r
r
r
r
e
a
a
a
K
a
a
a
a
a
a
a
G
a
a
e
a
a
a
a
i
a
a
a
a
a
a
a
F
a
a
a
a
a
a
f
f
f
e
"}
(8,1,1) = {"
r
r
r
r
e
l
l
l
X
a
a
a
a
a
a
a
a
a
a
e
e
a
a
a
e
e
a
a
K
a
a
a
F
a
a
a
a
a
a
a
a
a
e
"}
(9,1,1) = {"
r
r
r
r
e
a
a
g
B
g
a
a
a
a
a
a
a
a
a
e
e
a
a
a
e
e
a
a
K
a
e
e
e
a
a
a
a
a
a
a
a
a
e
"}
(10,1,1) = {"
r
r
r
r
e
a
a
g
V
g
a
a
a
a
a
a
a
a
e
e
e
h
a
a
e
e
a
a
K
a
e
r
e
a
a
a
a
a
a
a
a
a
e
"}
(11,1,1) = {"
r
r
r
r
e
G
a
g
g
g
a
a
a
a
a
a
a
e
e
r
e
h
a
a
e
e
e
a
K
a
e
r
e
a
a
a
a
a
a
a
a
a
e
"}
(12,1,1) = {"
r
r
r
r
e
a
a
B
g
g
a
a
a
a
a
a
e
e
r
r
e
a
a
a
e
r
e
e
e
e
e
r
e
a
a
a
a
a
a
a
a
a
e
"}
(13,1,1) = {"
r
r
r
r
e
e
H
e
e
e
h
a
h
e
e
e
e
r
e
e
e
e
a
a
e
r
r
r
r
r
r
r
e
e
e
e
e
e
b
b
b
b
e
"}
(14,1,1) = {"
r
r
r
r
r
e
J
a
G
a
a
a
a
a
a
a
e
r
e
a
a
e
J
J
e
r
r
r
r
r
r
r
r
r
r
r
r
e
U
U
U
U
e
"}
(15,1,1) = {"
r
r
r
r
r
e
a
a
G
a
a
a
a
a
a
a
e
r
e
a
a
w
a
a
e
r
r
r
r
r
r
r
r
r
r
r
r
e
U
T
T
T
e
"}
(16,1,1) = {"
r
r
r
r
r
e
a
a
a
a
a
a
a
h
h
a
e
r
e
a
a
w
a
a
e
r
r
r
r
r
r
r
r
r
r
r
r
e
N
T
T
T
e
"}
(17,1,1) = {"
r
r
r
r
r
e
h
a
a
a
a
a
a
a
a
e
e
r
e
a
a
e
e
e
e
r
r
r
r
r
r
r
r
r
r
r
r
e
N
T
T
T
e
"}
(18,1,1) = {"
r
r
r
r
r
e
h
a
a
a
a
a
a
a
a
e
e
r
e
a
a
e
r
r
r
r
r
r
r
r
r
r
r
r
r
r
r
e
v
T
T
T
e
"}
(19,1,1) = {"
r
r
r
r
r
e
e
e
e
a
a
a
a
a
a
a
e
r
e
a
a
e
r
r
r
r
r
r
r
r
r
r
r
r
r
r
r
e
I
T
T
T
e
"}
(20,1,1) = {"
r
r
r
r
r
r
r
r
e
h
a
a
a
a
a
a
e
e
e
a
a
e
e
e
e
e
e
e
e
e
e
e
e
e
e
e
e
e
D
T
T
T
e
"}
(21,1,1) = {"
r
r
r
r
r
r
r
r
e
h
a
a
a
a
a
a
a
a
a
a
K
Q
Q
Q
Q
Q
Q
Q
a
a
a
a
a
a
a
a
a
b
D
T
T
T
e
"}
(22,1,1) = {"
r
r
r
r
r
r
r
r
e
h
a
a
a
a
a
a
a
a
a
a
a
Q
Q
Q
Q
Q
Q
Q
a
a
a
a
a
a
a
a
a
b
D
U
U
U
e
"}
(23,1,1) = {"
r
r
r
r
r
r
r
r
e
e
b
b
e
e
e
e
e
a
a
K
a
Q
Q
Q
Q
Q
Q
Q
a
a
a
e
e
e
e
e
e
e
b
b
b
b
e
"}
(24,1,1) = {"
r
r
r
r
r
r
r
r
r
e
a
a
a
a
e
r
e
e
e
e
e
e
F
F
F
F
F
F
a
a
a
e
r
r
r
r
r
e
a
a
a
a
e
"}
(25,1,1) = {"
r
r
r
r
r
r
r
r
r
e
a
a
a
a
e
r
r
r
r
e
a
a
a
a
a
a
a
a
a
a
a
e
r
r
r
r
r
e
a
a
a
a
e
"}
(26,1,1) = {"
r
r
r
r
r
r
r
r
e
e
e
e
b
b
e
e
e
e
e
e
a
a
a
a
a
a
a
a
a
a
a
e
e
e
e
e
e
e
a
a
a
a
e
"}
(27,1,1) = {"
r
r
r
r
r
r
r
r
e
R
R
R
R
R
e
a
a
a
a
a
a
a
e
e
e
e
e
e
e
a
a
e
a
a
a
a
a
a
a
a
a
a
e
"}
(28,1,1) = {"
r
r
r
r
r
r
r
r
e
R
z
z
z
R
e
a
a
a
a
a
a
a
e
r
r
r
r
r
e
a
a
a
a
a
a
a
a
a
a
a
a
a
e
"}
(29,1,1) = {"
r
r
r
r
r
r
r
r
e
O
z
z
z
d
e
a
a
a
a
e
e
e
e
r
r
r
r
r
e
a
a
a
a
a
a
a
a
a
a
a
a
a
e
"}
(30,1,1) = {"
r
r
r
r
r
r
r
r
e
P
z
z
z
d
e
a
a
e
e
e
r
r
r
r
r
r
r
r
e
a
a
a
a
a
a
a
a
a
a
a
a
a
e
"}
(31,1,1) = {"
r
r
r
r
r
r
r
r
e
M
z
z
z
R
e
a
a
e
r
r
r
r
r
r
r
r
r
r
e
a
a
a
a
a
a
a
a
a
a
a
a
a
e
"}
(32,1,1) = {"
r
r
r
r
r
r
r
r
e
M
z
z
z
R
e
a
a
e
r
r
r
r
r
r
r
r
r
r
e
a
a
a
a
a
a
a
a
a
a
a
a
a
e
"}
(33,1,1) = {"
r
r
r
r
r
r
r
r
e
R
z
z
z
P
e
a
a
e
r
r
r
r
r
r
r
r
r
r
e
a
a
a
a
a
a
a
a
a
a
a
a
a
e
"}
(34,1,1) = {"
r
r
r
r
r
r
r
r
e
R
z
z
z
P
e
a
a
e
r
r
r
r
r
r
r
r
r
r
e
a
a
a
a
a
a
a
a
a
a
a
a
a
e
"}
(35,1,1) = {"
r
r
r
r
r
r
r
r
e
R
z
z
z
Z
s
a
a
e
r
e
e
e
e
e
e
e
e
e
e
a
a
a
a
a
a
a
a
a
a
a
a
a
e
"}
(36,1,1) = {"
r
r
r
r
r
r
r
r
e
R
z
z
z
Z
s
a
a
e
r
e
a
a
a
a
a
a
a
G
e
a
a
a
a
a
a
a
a
a
a
a
a
a
e
"}
(37,1,1) = {"
r
r
r
r
r
r
r
r
e
R
R
R
R
Z
s
a
a
e
r
e
a
a
a
a
a
a
a
a
e
a
a
a
a
a
a
a
a
a
a
a
a
a
e
"}
(38,1,1) = {"
r
r
r
r
r
r
r
r
e
R
R
R
e
e
s
a
a
e
r
e
a
a
a
a
e
a
a
a
a
a
a
a
a
a
a
a
a
a
a
a
a
a
e
"}
(39,1,1) = {"
r
r
r
r
e
e
e
e
e
b
b
b
e
e
e
e
e
e
r
e
a
a
a
a
e
G
G
a
a
a
a
a
a
e
e
e
e
a
a
a
a
a
e
"}
(40,1,1) = {"
r
r
r
r
e
a
a
a
a
a
a
a
e
r
r
r
r
r
r
e
a
a
a
a
e
e
e
e
e
e
e
e
e
e
r
r
e
e
e
e
e
e
e
"}
(41,1,1) = {"
r
r
r
r
e
a
a
a
a
a
a
a
e
r
r
r
r
r
r
e
a
a
a
a
e
r
r
r
r
r
r
r
r
r
r
r
r
r
r
r
r
r
r
"}
(42,1,1) = {"
r
r
r
r
e
a
a
a
a
a
a
a
e
r
r
r
r
r
r
e
a
a
a
a
e
r
r
r
r
r
r
r
r
r
r
r
r
r
r
r
r
r
r
"}
(43,1,1) = {"
r
r
r
r
e
a
a
a
a
G
G
a
e
r
r
r
r
r
r
e
a
a
a
a
e
r
r
r
r
r
r
r
r
r
r
r
r
r
r
r
r
r
r
"}
(44,1,1) = {"
r
r
r
r
e
a
a
a
g
g
g
a
e
r
r
r
r
r
r
e
a
a
a
a
e
r
r
r
r
r
r
r
r
r
r
r
r
r
r
r
r
r
r
"}
(45,1,1) = {"
r
r
r
r
e
a
a
a
g
g
g
G
e
r
r
r
r
r
r
e
a
a
a
a
e
r
r
r
r
r
r
r
r
r
r
r
r
r
r
r
r
r
r
"}
(46,1,1) = {"
r
r
r
r
e
a
a
h
g
A
g
G
e
r
r
r
r
r
r
e
G
a
a
a
e
r
r
r
r
r
r
r
r
r
r
r
r
r
r
r
r
r
r
"}
(47,1,1) = {"
r
r
r
r
e
a
a
h
g
q
g
a
e
r
r
r
r
r
r
e
G
a
a
a
e
r
r
r
r
r
r
r
r
r
r
r
r
r
r
r
r
r
r
"}
(48,1,1) = {"
r
r
r
r
e
a
a
a
g
g
g
a
e
r
r
r
r
r
r
e
G
a
a
a
e
r
r
r
r
r
r
r
r
r
r
r
r
r
r
r
r
r
r
"}
(49,1,1) = {"
r
r
r
r
e
a
a
a
l
l
l
l
e
e
e
e
e
e
e
e
a
a
a
a
e
r
r
r
r
r
r
r
r
r
r
r
r
r
r
r
r
r
r
"}
(50,1,1) = {"
r
r
r
r
e
a
a
a
a
a
a
a
F
a
a
a
a
a
a
a
a
a
a
a
e
e
e
e
e
r
r
r
r
r
r
r
r
r
r
r
r
r
r
"}
(51,1,1) = {"
r
r
r
r
e
a
a
a
a
a
a
a
a
a
a
a
a
a
a
a
a
a
a
a
a
a
a
G
e
r
r
r
r
r
r
r
r
r
r
r
r
r
r
"}
(52,1,1) = {"
r
r
r
r
e
a
a
a
a
a
a
a
a
a
a
a
a
a
a
a
a
a
a
a
a
a
a
a
e
r
r
r
r
r
r
r
r
r
r
r
r
r
r
"}
(53,1,1) = {"
r
r
r
r
e
a
a
a
a
a
a
a
a
e
e
e
e
a
a
a
a
a
a
a
a
a
a
a
e
r
r
r
r
r
r
r
r
r
r
r
r
r
r
"}
(54,1,1) = {"
e
e
e
e
e
e
e
e
e
e
e
e
e
e
e
e
e
e
e
e
e
e
e
e
e
e
e
e
e
r
r
r
r
r
r
r
r
r
r
r
r
r
r
"}
