//MAP CONVERTED BY dmm2tgm.py THIS HEADER COMMENT PREVENTS RECONVERSION, DO NOT REMOVE
"a" = (
/obj/effect/lighting_dummy/daylight,
/turf/unsimulated/floor/hammereditor/dev12,
/area/warfare)
"b" = (
/obj/hammereditor/playerclip/defuse,
/obj/effect/lighting_dummy/daylight,
/turf/unsimulated/floor/hammereditor/dev12,
/area/warfare)
"e" = (
/obj/effect/lighting_dummy/daylight,
/turf/simulated/wall/perspecticrete,
/area/warfare)
"g" = (
/obj/effect/lighting_dummy/daylight,
/turf/unsimulated/floor/hammereditor/dev22,
/area/warfare/bombsite)
"h" = (
/obj/structure/ore_box,
/obj/effect/lighting_dummy/daylight,
/turf/unsimulated/floor/hammereditor/dev12,
/area/warfare)
"i" = (
/obj/structure/warfare/barricade/concrete_barrier{
	dir = 1
	},
/obj/effect/lighting_dummy/daylight,
/turf/unsimulated/floor/hammereditor/dev12,
/area/warfare)
"l" = (
/obj/structure/warfare/barricade/concrete_barrier{
	dir = 4
	},
/obj/effect/lighting_dummy/daylight,
/turf/unsimulated/floor/hammereditor/dev12,
/area/warfare)
"q" = (
/obj/effect/lighting_dummy/daylight,
/turf/unsimulated/floor/hammereditor/dev2,
/area/warfare/bombsite)
"r" = (
/obj/effect/lighting_dummy/daylight,
/turf/unsimulated/wall/hammereditor/dev2,
/area/warfare)
"w" = (
/obj/effect/lighting_dummy/daylight,
/turf/simulated/floor/tiled/ramp{
	dir = 1
	},
/area/warfare)
"z" = (
/obj/effect/landmark/start{
	name = "Red Soldier"
	},
/obj/effect/lighting_dummy/daylight,
/turf/unsimulated/floor/hammereditor/dev12,
/area/warfare)
"F" = (
/obj/structure/dirt_wall,
/obj/effect/lighting_dummy/daylight,
/turf/unsimulated/floor/hammereditor/dev12,
/area/warfare)
"I" = (
/obj/item/plastique/keypad/blue/defuse,
/obj/effect/lighting_dummy/daylight,
/turf/unsimulated/floor/hammereditor/dev12,
/area/warfare)
"J" = (
/obj/effect/lighting_dummy/daylight,
/turf/simulated/floor/tiled/ramp{
	dir = 4
	},
/area/warfare)
"K" = (
/obj/structure/warfare/barricade/concrete_barrier,
/obj/effect/lighting_dummy/daylight,
/turf/unsimulated/floor/hammereditor/dev12,
/area/warfare)
"P" = (
/obj/item/bombdefusal,
/obj/effect/lighting_dummy/daylight,
/turf/unsimulated/floor/hammereditor/dev12,
/area/warfare)
"Q" = (
/obj/effect/lighting_dummy/daylight,
/turf/simulated/floor/tiled/ramp,
/area/warfare)
"R" = (
/obj/effect/landmark/start{
	name = "Blue Soldier"
	},
/obj/effect/lighting_dummy/daylight,
/turf/unsimulated/floor/hammereditor/dev12,
/area/warfare)
"S" = (
/obj/effect/landmark/start{
	name = "Red Engineer"
	},
/obj/effect/lighting_dummy/daylight,
/turf/unsimulated/floor/hammereditor/dev12,
/area/warfare)
"T" = (
/obj/effect/landmark/start{
	name = "Blue Engineer"
	},
/obj/effect/lighting_dummy/daylight,
/turf/unsimulated/floor/hammereditor/dev12,
/area/warfare)
"X" = (
/obj/structure/warfare/barricade/concrete_barrier{
	dir = 4
	},
/obj/structure/warfare/barricade/concrete_barrier,
/obj/effect/lighting_dummy/daylight,
/turf/unsimulated/floor/hammereditor/dev12,
/area/warfare)

(1,1,1) = {"
e
e
e
e
e
e
e
e
e
e
e
e
e
e
e
e
e
e
e
e
e
e
e
e
e
e
e
e
e
e
e
e
e
e
e
e
e
e
e
e
e
e
e
"}
(2,1,1) = {"
e
a
a
a
a
a
a
h
K
a
a
a
a
a
a
a
e
e
e
e
h
a
a
a
e
e
e
a
K
a
a
a
Q
Q
Q
Q
Q
Q
Q
a
a
a
e
"}
(3,1,1) = {"
e
a
a
a
a
a
a
a
a
Q
a
a
a
a
a
a
i
a
a
a
a
a
a
a
e
e
a
a
K
a
a
a
Q
Q
Q
Q
Q
Q
Q
a
a
a
e
"}
(4,1,1) = {"
e
h
h
a
a
a
a
a
a
Q
a
a
a
a
a
a
a
a
a
i
a
a
a
a
e
e
a
a
K
a
a
a
Q
Q
Q
Q
Q
Q
Q
a
a
a
e
"}
(5,1,1) = {"
e
h
h
a
a
a
a
a
K
a
a
a
a
a
a
a
e
e
e
e
a
a
a
a
e
e
a
a
K
a
a
a
F
F
F
F
F
F
F
a
a
a
e
"}
(6,1,1) = {"
e
e
e
e
e
a
a
a
K
a
a
a
a
a
a
a
e
e
e
e
a
a
a
a
a
K
a
a
a
a
a
a
F
a
a
a
a
a
a
a
a
a
e
"}
(7,1,1) = {"
r
r
r
r
e
a
a
a
K
a
a
a
a
a
a
a
a
a
a
e
a
a
a
a
i
a
a
a
a
a
a
a
F
a
a
a
a
a
a
a
a
a
e
"}
(8,1,1) = {"
r
r
r
r
e
l
l
l
X
a
a
a
a
a
a
a
a
a
a
e
e
a
a
a
e
e
a
a
K
a
a
a
F
a
a
a
a
a
a
a
a
a
e
"}
(9,1,1) = {"
r
r
r
r
e
a
a
g
g
g
a
a
a
a
a
a
a
a
a
e
e
a
a
a
e
e
a
a
K
a
e
e
e
a
a
a
a
a
a
a
a
a
e
"}
(10,1,1) = {"
r
r
r
r
e
a
a
g
q
g
a
a
a
a
a
a
a
a
e
e
e
h
a
a
e
e
a
a
K
a
e
r
e
a
a
a
a
a
a
a
a
a
e
"}
(11,1,1) = {"
r
r
r
r
e
a
a
g
g
g
a
a
a
a
a
a
a
e
e
r
e
h
a
a
e
e
e
a
K
a
e
r
e
a
a
a
a
a
a
a
a
a
e
"}
(12,1,1) = {"
r
r
r
r
e
a
a
g
g
g
a
a
a
a
a
a
e
e
r
r
e
a
a
a
e
r
e
e
e
e
e
r
e
a
a
a
a
a
a
a
a
a
e
"}
(13,1,1) = {"
r
r
r
r
e
e
e
e
e
e
h
a
h
e
e
e
e
r
e
e
e
e
a
a
e
r
r
r
r
r
r
r
e
e
e
e
e
e
b
b
b
b
e
"}
(14,1,1) = {"
r
r
r
r
r
e
a
a
a
a
a
a
a
a
a
a
e
r
e
a
a
e
J
J
e
r
r
r
r
r
r
r
r
r
r
r
r
e
a
a
a
a
e
"}
(15,1,1) = {"
r
r
r
r
r
e
a
a
a
a
a
a
a
a
a
a
e
r
e
a
a
w
a
a
e
r
r
r
r
r
r
r
r
r
r
r
r
e
a
T
T
T
e
"}
(16,1,1) = {"
r
r
r
r
r
e
a
a
a
a
a
a
a
h
h
a
e
r
e
a
a
w
a
a
e
r
r
r
r
r
r
r
r
r
r
r
r
e
a
T
T
T
e
"}
(17,1,1) = {"
r
r
r
r
r
e
h
a
a
a
a
a
a
a
a
e
e
r
e
a
a
e
e
e
e
r
r
r
r
r
r
r
r
r
r
r
r
e
a
T
T
T
e
"}
(18,1,1) = {"
r
r
r
r
r
e
h
a
a
a
a
a
a
a
a
e
e
r
e
a
a
e
r
r
r
r
r
r
r
r
r
r
r
r
r
r
r
e
a
R
R
R
e
"}
(19,1,1) = {"
r
r
r
r
r
e
e
e
e
a
a
a
a
a
a
a
e
r
e
a
a
e
r
r
r
r
r
r
r
r
r
r
r
r
r
r
r
e
I
R
R
R
e
"}
(20,1,1) = {"
r
r
r
r
r
r
r
r
e
h
a
a
a
a
a
a
e
e
e
a
a
e
e
e
e
e
e
e
e
e
e
e
e
e
e
e
e
e
a
R
R
R
e
"}
(21,1,1) = {"
r
r
r
r
r
r
r
r
e
h
a
a
a
a
a
a
a
a
a
a
K
Q
Q
Q
Q
Q
Q
Q
a
a
a
a
a
a
a
a
a
b
a
a
a
a
e
"}
(22,1,1) = {"
r
r
r
r
r
r
r
r
e
h
a
a
a
a
a
a
a
a
a
a
a
Q
Q
Q
Q
Q
Q
Q
a
a
a
a
a
a
a
a
a
b
a
a
a
a
e
"}
(23,1,1) = {"
r
r
r
r
r
r
r
r
e
e
b
b
e
e
e
e
e
a
a
K
a
Q
Q
Q
Q
Q
Q
Q
a
a
a
e
e
e
e
e
e
e
b
b
b
b
e
"}
(24,1,1) = {"
r
r
r
r
r
r
r
r
r
e
a
a
a
a
e
r
e
e
e
e
e
e
F
F
F
F
F
F
a
a
a
e
r
r
r
r
r
e
a
a
a
a
e
"}
(25,1,1) = {"
r
r
r
r
r
r
r
r
r
e
a
a
a
a
e
r
r
r
r
e
a
a
a
a
a
a
a
a
a
a
a
e
r
r
r
r
r
e
a
a
a
a
e
"}
(26,1,1) = {"
r
r
r
r
r
r
r
r
e
e
e
e
b
b
e
e
e
e
e
e
a
a
a
a
a
a
a
a
a
a
a
e
e
e
e
e
e
e
a
a
a
a
e
"}
(27,1,1) = {"
r
r
r
r
r
r
r
r
e
P
a
a
a
a
e
a
a
a
a
Q
a
a
e
e
e
e
e
e
e
a
a
e
a
a
a
a
a
a
a
a
a
a
e
"}
(28,1,1) = {"
r
r
r
r
r
r
r
r
e
P
a
a
a
a
e
a
a
a
a
Q
a
a
e
r
r
r
r
r
e
a
a
a
a
a
a
a
a
a
a
a
a
a
e
"}
(29,1,1) = {"
r
r
r
r
r
r
r
r
e
P
S
S
S
a
e
a
a
a
a
e
e
e
e
r
r
r
r
r
e
a
a
a
a
a
a
a
a
a
a
a
a
a
e
"}
(30,1,1) = {"
r
r
r
r
r
r
r
r
e
P
S
S
S
a
e
a
a
e
e
e
r
r
r
r
r
r
r
r
e
a
a
a
a
a
a
a
a
a
a
a
a
a
e
"}
(31,1,1) = {"
r
r
r
r
r
r
r
r
e
a
S
S
S
P
e
a
a
e
r
r
r
r
r
r
r
r
r
r
e
a
a
a
a
a
a
a
a
a
a
a
a
a
e
"}
(32,1,1) = {"
r
r
r
r
r
r
r
r
e
a
z
z
z
P
e
a
a
e
r
r
r
r
r
r
r
r
r
r
e
a
a
a
a
a
a
a
a
a
a
a
a
a
e
"}
(33,1,1) = {"
r
r
r
r
r
r
r
r
e
a
z
z
z
P
e
a
a
e
r
r
r
r
r
r
r
r
r
r
e
a
a
a
a
a
a
a
a
a
a
a
a
a
e
"}
(34,1,1) = {"
r
r
r
r
r
r
r
r
e
a
z
z
z
P
e
a
a
e
r
r
r
r
r
r
r
r
r
r
e
a
a
a
a
a
a
a
a
a
a
a
a
a
e
"}
(35,1,1) = {"
r
r
r
r
r
r
r
r
e
a
a
a
a
a
a
a
a
e
r
e
e
e
e
e
e
e
e
e
e
a
a
a
a
a
a
a
a
a
a
a
a
a
e
"}
(36,1,1) = {"
r
r
r
r
r
r
r
r
e
a
a
a
a
a
a
a
a
e
r
e
a
a
a
a
a
a
a
a
e
a
a
a
a
a
a
a
a
a
a
a
a
a
e
"}
(37,1,1) = {"
r
r
r
r
r
r
r
r
e
a
a
a
a
a
a
a
a
e
r
e
a
a
a
a
a
a
a
a
e
a
a
a
a
a
a
a
a
a
a
a
a
a
e
"}
(38,1,1) = {"
r
r
r
r
r
r
r
r
e
a
a
a
e
e
a
a
a
e
r
e
a
a
a
a
e
a
a
a
a
a
a
a
a
a
a
a
a
a
a
a
a
a
e
"}
(39,1,1) = {"
r
r
r
r
e
e
e
e
e
b
b
b
e
e
e
e
e
e
r
e
a
a
a
a
e
a
a
a
a
a
a
a
a
e
e
e
e
a
a
a
a
a
e
"}
(40,1,1) = {"
r
r
r
r
e
a
a
a
a
a
a
a
e
r
r
r
r
r
r
e
a
a
a
a
e
e
e
e
e
e
e
e
e
e
r
r
e
e
e
e
e
e
e
"}
(41,1,1) = {"
r
r
r
r
e
a
a
a
a
a
a
a
e
r
r
r
r
r
r
e
a
a
a
a
e
r
r
r
r
r
r
r
r
r
r
r
r
r
r
r
r
r
r
"}
(42,1,1) = {"
r
r
r
r
e
a
a
a
a
a
a
a
e
r
r
r
r
r
r
e
a
a
a
a
e
r
r
r
r
r
r
r
r
r
r
r
r
r
r
r
r
r
r
"}
(43,1,1) = {"
r
r
r
r
e
a
a
a
a
a
a
a
e
r
r
r
r
r
r
e
a
a
a
a
e
r
r
r
r
r
r
r
r
r
r
r
r
r
r
r
r
r
r
"}
(44,1,1) = {"
r
r
r
r
e
a
a
a
g
g
g
a
e
r
r
r
r
r
r
e
a
a
a
a
e
r
r
r
r
r
r
r
r
r
r
r
r
r
r
r
r
r
r
"}
(45,1,1) = {"
r
r
r
r
e
a
a
a
g
g
g
a
e
r
r
r
r
r
r
e
a
a
a
a
e
r
r
r
r
r
r
r
r
r
r
r
r
r
r
r
r
r
r
"}
(46,1,1) = {"
r
r
r
r
e
a
a
h
g
g
g
a
e
r
r
r
r
r
r
e
a
a
a
a
e
r
r
r
r
r
r
r
r
r
r
r
r
r
r
r
r
r
r
"}
(47,1,1) = {"
r
r
r
r
e
a
a
h
g
q
g
a
e
r
r
r
r
r
r
e
a
a
a
a
e
r
r
r
r
r
r
r
r
r
r
r
r
r
r
r
r
r
r
"}
(48,1,1) = {"
r
r
r
r
e
a
a
a
g
g
g
a
e
r
r
r
r
r
r
e
a
a
a
a
e
r
r
r
r
r
r
r
r
r
r
r
r
r
r
r
r
r
r
"}
(49,1,1) = {"
r
r
r
r
e
a
a
a
l
l
l
l
e
e
e
e
e
e
e
e
a
a
a
a
e
r
r
r
r
r
r
r
r
r
r
r
r
r
r
r
r
r
r
"}
(50,1,1) = {"
r
r
r
r
e
a
a
a
a
a
a
a
F
a
a
a
a
a
a
a
a
a
a
a
e
e
e
e
e
r
r
r
r
r
r
r
r
r
r
r
r
r
r
"}
(51,1,1) = {"
r
r
r
r
e
a
a
a
a
a
a
a
a
a
a
a
a
a
a
a
a
a
a
a
a
a
a
a
e
r
r
r
r
r
r
r
r
r
r
r
r
r
r
"}
(52,1,1) = {"
r
r
r
r
e
a
a
a
a
a
a
a
a
a
a
a
a
a
a
a
a
a
a
a
a
a
a
a
e
r
r
r
r
r
r
r
r
r
r
r
r
r
r
"}
(53,1,1) = {"
r
r
r
r
e
a
a
a
a
a
a
a
a
e
e
e
e
a
a
a
a
a
a
a
a
a
a
a
e
r
r
r
r
r
r
r
r
r
r
r
r
r
r
"}
(54,1,1) = {"
e
e
e
e
e
e
e
e
e
e
e
e
e
e
e
e
e
e
e
e
e
e
e
e
e
e
e
e
e
r
r
r
r
r
r
r
r
r
r
r
r
r
r
"}
