//MAP CONVERTED BY dmm2tgm.py THIS HEADER COMMENT PREVENTS RECONVERSION, DO NOT REMOVE
"a" = (
/obj/effect/lighting_dummy/daylight,
/turf/unsimulated/floor/hammereditor/dev1,
/area/warfare)
"f" = (
/obj/effect/lighting_dummy/daylight,
/obj/structure/warfare/barricade/concrete_barrier{
	dir = 4
	},
/turf/unsimulated/floor/hammereditor/dev22,
/area/warfare/bombsite)
"g" = (
/obj/effect/lighting_dummy/daylight,
/obj/structure/statue/verina{
	density = 0;
	pixel_x = -16;
	pixel_y = 1
	},
/turf/unsimulated/floor/hammereditor/dev22,
/area/warfare/bombsite)
"k" = (
/obj/effect/landmark/start{
	name = "Red Soldier"
	},
/obj/effect/lighting_dummy/daylight,
/obj/item/bombdefusal,
/obj/effect/landmark/start{
	name = "Red Engineer"
	},
/turf/unsimulated/floor/hammereditor/dev1,
/area/warfare)
"l" = (
/obj/effect/landmark/start{
	name = "Blue Soldier"
	},
/obj/item/plastique/keypad/blue/defuse,
/obj/effect/lighting_dummy/daylight,
/obj/effect/landmark/start{
	name = "Blue Engineer"
	},
/turf/unsimulated/floor/hammereditor/dev1,
/area/warfare)
"n" = (
/obj/effect/lighting_dummy/daylight,
/turf/unsimulated/floor/hammereditor/dev22,
/area/warfare)
"q" = (
/obj/effect/landmark/start{
	name = "Blue Soldier"
	},
/obj/effect/lighting_dummy/daylight,
/obj/effect/landmark/start{
	name = "Blue Engineer"
	},
/turf/unsimulated/floor/hammereditor/dev1,
/area/warfare)
"r" = (
/obj/effect/landmark/test/space_turf,
/obj/effect/lighting_dummy/daylight,
/turf/unsimulated/wall/hammereditor/dev2,
/area/warfare)
"u" = (
/obj/effect/landmark/map_data,
/obj/effect/lighting_dummy/daylight,
/turf/unsimulated/wall/hammereditor/dev2,
/area/warfare)
"v" = (
/obj/effect/lighting_dummy/daylight,
/turf/unsimulated/wall/hammereditor/dev3,
/area/warfare)
"w" = (
/obj/structure/ore_box,
/obj/effect/lighting_dummy/daylight,
/turf/unsimulated/floor/hammereditor/dev1,
/area/warfare)
"y" = (
/obj/effect/landmark/start{
	name = "Red Soldier"
	},
/obj/effect/lighting_dummy/daylight,
/obj/item/bombdefusal,
/obj/effect/landmark/start{
	name = "Red Engineer"
	},
/turf/unsimulated/floor/hammereditor/dev22,
/area/warfare)
"z" = (
/obj/effect/lighting_dummy/daylight,
/obj/machinery/telecomms/allinone{
	intercept = 1
	},
/turf/unsimulated/wall/hammereditor/dev2,
/area/warfare)
"A" = (
/obj/effect/landmark/test/safe_turf,
/obj/effect/lighting_dummy/daylight,
/turf/unsimulated/wall/hammereditor/dev2,
/area/warfare)
"C" = (
/obj/effect/lighting_dummy/daylight,
/obj/structure/table/rack/shelf/red,
/obj/item/storage/fancy/cigarettes/carcinomas,
/obj/item/storage/fancy/cigarettes/carcinomas,
/obj/item/storage/fancy/cigarettes/jerichos,
/obj/item/flame/lighter/zippo,
/turf/unsimulated/floor/hammereditor/dev1,
/area/warfare)
"E" = (
/obj/effect/lighting_dummy/daylight,
/obj/structure/table/rack/shelf/red,
/turf/unsimulated/floor/hammereditor/dev1,
/area/warfare)
"F" = (
/obj/effect/lighting_dummy/daylight,
/obj/structure/ore_box,
/turf/unsimulated/floor/hammereditor/dev1,
/area/warfare)
"G" = (
/obj/effect/lighting_dummy/daylight,
/turf/unsimulated/floor/hammereditor/dev22,
/area/warfare/bombsite)
"H" = (
/obj/effect/lighting_dummy/daylight,
/turf/unsimulated/wall/hammereditor/dev2,
/area/warfare)
"I" = (
/obj/effect/lighting_dummy/daylight,
/obj/structure/warfare/barricade/concrete_barrier{
	dir = 8
	},
/turf/unsimulated/floor/hammereditor/dev22,
/area/warfare/bombsite)
"K" = (
/obj/effect/lighting_dummy/daylight,
/obj/machinery/door/unpowered/simple/interiorglass,
/turf/unsimulated/floor/hammereditor/dev1,
/area/warfare)
"O" = (
/obj/effect/lighting_dummy/daylight,
/turf/unsimulated/wall/hammereditor/dev2,
/area/warfare/bombsite)
"P" = (
/obj/effect/landmark/start{
	name = "Red Soldier"
	},
/obj/effect/lighting_dummy/daylight,
/obj/effect/landmark/start{
	name = "Red Engineer"
	},
/turf/unsimulated/floor/hammereditor/dev1,
/area/warfare)
"S" = (
/obj/effect/lighting_dummy/daylight,
/obj/machinery/door/unpowered/simple/interiorroom,
/turf/unsimulated/floor/hammereditor/dev1,
/area/warfare)
"T" = (
/obj/effect/landmark/start,
/obj/effect/lighting_dummy/daylight,
/turf/unsimulated/wall/hammereditor/dev2,
/area/warfare)
"U" = (
/obj/effect/landmark/start{
	name = "Blue Soldier"
	},
/obj/effect/lighting_dummy/daylight,
/obj/effect/landmark/start{
	name = "Blue Engineer"
	},
/turf/unsimulated/floor/hammereditor/dev22,
/area/warfare)
"V" = (
/obj/hammereditor/playerclip/defuse,
/obj/effect/lighting_dummy/daylight,
/turf/unsimulated/floor/hammereditor/dev12,
/area/warfare)
"W" = (
/obj/effect/landmark{
	name = "tdome1"
	},
/obj/effect/lighting_dummy/daylight,
/turf/unsimulated/floor/hammereditor/dev1,
/area/warfare)
"X" = (
/obj/effect/landmark{
	name = "JoinLate"
	},
/obj/effect/lighting_dummy/daylight,
/turf/unsimulated/floor/hammereditor/dev1,
/area/warfare)
"Y" = (
/obj/effect/lighting_dummy/daylight,
/obj/structure/warfare/barricade/concrete_barrier,
/turf/unsimulated/floor/hammereditor/dev22,
/area/warfare/bombsite)

(1,1,1) = {"
H
H
H
H
H
H
H
H
H
H
H
H
H
H
H
H
H
H
H
H
H
H
H
H
H
H
H
H
H
H
H
A
"}
(2,1,1) = {"
H
H
H
H
H
H
a
a
a
a
a
a
a
a
a
a
a
a
a
a
a
a
a
a
a
a
a
a
W
W
W
r
"}
(3,1,1) = {"
H
q
q
q
q
H
a
a
a
a
a
a
a
a
a
a
a
a
a
H
H
H
S
H
H
H
H
H
W
W
W
u
"}
(4,1,1) = {"
H
q
q
q
U
V
n
a
a
a
a
a
a
a
a
a
a
a
a
H
F
F
a
a
a
a
a
H
W
W
W
T
"}
(5,1,1) = {"
H
q
q
l
U
V
n
a
a
a
a
a
a
a
a
a
a
a
a
H
C
G
G
G
F
a
a
K
X
X
X
H
"}
(6,1,1) = {"
H
q
q
q
q
H
a
a
a
a
a
a
a
a
a
a
a
a
a
H
E
G
G
G
a
a
a
H
X
X
X
H
"}
(7,1,1) = {"
H
H
H
H
H
H
a
a
a
a
a
a
a
a
a
a
H
H
H
H
H
O
f
f
a
a
a
H
X
X
X
H
"}
(8,1,1) = {"
H
a
a
a
a
a
a
a
H
a
a
a
a
a
a
a
a
a
H
E
F
F
F
a
a
a
a
H
a
a
a
H
"}
(9,1,1) = {"
H
a
a
a
a
a
a
a
H
a
a
a
a
a
a
a
a
a
H
E
a
a
a
a
a
a
a
H
a
a
a
H
"}
(10,1,1) = {"
H
a
a
a
a
a
a
a
H
a
a
a
a
a
a
a
a
a
H
E
a
a
a
a
a
a
a
H
a
a
a
H
"}
(11,1,1) = {"
H
a
a
a
a
a
a
a
H
a
a
a
a
a
a
a
a
w
H
H
H
S
H
H
H
H
H
H
a
a
a
H
"}
(12,1,1) = {"
H
a
a
a
a
a
a
a
v
a
a
a
a
a
a
a
w
w
H
a
a
a
a
a
a
a
a
v
a
a
a
H
"}
(13,1,1) = {"
H
a
a
a
a
a
a
a
H
a
a
a
a
a
a
a
w
w
H
a
a
a
a
a
a
a
a
H
a
a
a
H
"}
(14,1,1) = {"
H
a
a
a
a
a
a
a
H
a
a
a
a
a
H
H
H
H
H
a
a
a
a
a
a
a
a
H
a
a
a
H
"}
(15,1,1) = {"
H
a
a
a
a
a
a
a
H
a
a
a
a
a
a
a
a
a
a
a
a
a
a
a
a
a
a
H
a
a
a
H
"}
(16,1,1) = {"
H
a
a
a
a
a
a
a
H
a
a
a
a
a
a
a
a
a
a
a
a
a
a
a
a
a
a
H
a
a
a
H
"}
(17,1,1) = {"
H
a
a
a
a
a
a
a
H
H
H
H
a
a
a
a
a
a
a
a
a
a
a
a
H
H
H
H
a
a
a
H
"}
(18,1,1) = {"
H
a
a
a
a
a
a
a
a
a
a
a
a
a
a
a
a
a
a
a
a
a
a
a
a
a
a
a
a
a
a
H
"}
(19,1,1) = {"
H
a
a
a
a
a
a
a
a
a
a
H
a
a
a
a
a
a
a
a
a
a
a
a
a
a
a
a
a
a
a
H
"}
(20,1,1) = {"
H
a
H
H
H
H
H
a
a
a
a
H
a
a
a
a
a
a
a
a
a
a
a
a
a
a
a
a
a
a
a
H
"}
(21,1,1) = {"
H
a
a
a
F
H
a
a
a
a
a
a
a
a
a
a
a
a
a
a
a
a
a
a
a
a
a
a
a
a
a
H
"}
(22,1,1) = {"
H
a
a
a
a
a
a
a
I
G
Y
a
a
a
a
H
H
H
H
H
H
H
a
a
a
a
a
a
a
a
a
H
"}
(23,1,1) = {"
H
a
a
a
a
a
a
a
G
g
Y
a
a
a
a
a
a
a
a
a
a
a
a
a
a
a
a
a
a
a
a
H
"}
(24,1,1) = {"
H
a
a
a
a
a
a
a
f
G
Y
a
a
a
a
a
a
a
a
a
a
a
a
a
a
a
a
a
a
a
a
H
"}
(25,1,1) = {"
H
a
a
a
a
a
a
a
a
a
a
a
a
a
a
a
a
a
a
a
a
a
a
a
a
a
a
a
a
a
a
H
"}
(26,1,1) = {"
H
a
a
H
H
a
a
H
H
a
a
a
a
a
a
a
a
a
a
a
a
a
a
a
a
a
a
a
a
a
a
H
"}
(27,1,1) = {"
H
a
a
a
a
a
a
a
a
a
a
a
H
a
a
a
a
a
a
a
a
a
a
a
a
a
H
H
H
H
H
z
"}
(28,1,1) = {"
H
a
a
a
H
a
a
a
a
a
a
w
H
a
a
a
a
a
a
a
a
a
a
a
a
a
H
k
P
P
P
H
"}
(29,1,1) = {"
H
a
a
a
H
a
a
a
a
a
w
w
H
a
a
a
a
a
a
a
a
a
a
a
a
n
V
y
P
P
P
H
"}
(30,1,1) = {"
H
a
a
H
H
a
a
a
H
H
H
H
H
a
a
a
a
a
a
a
a
a
a
a
a
n
V
y
P
P
P
H
"}
(31,1,1) = {"
H
a
a
a
a
a
a
a
a
a
a
a
a
a
a
a
a
a
a
a
a
a
a
a
a
a
H
k
P
P
P
H
"}
(32,1,1) = {"
H
H
H
H
H
H
H
H
H
H
H
H
H
H
H
H
H
H
H
H
H
H
H
H
H
H
H
H
H
H
H
H
"}
