//MAP CONVERTED BY dmm2tgm.py THIS HEADER COMMENT PREVENTS RECONVERSION, DO NOT REMOVE
"a" = (
/obj/effect/lighting_dummy/yellowlight,
/turf/unsimulated/floor/hammereditor/dev1,
/area/warfare/map)
"b" = (
/obj/effect/lighting_dummy/yellowlight,
/obj/machinery/door/unpowered/simple/interiorglass,
/turf/unsimulated/floor/hammereditor/dev1,
/area/warfare/map)
"c" = (
/obj/effect/lighting_dummy/yellowlight,
/obj/structure/table/rack/shelf/red,
/turf/unsimulated/floor/hammereditor/dev1,
/area/warfare/map)
"d" = (
/obj/effect/landmark/start{
	name = "Red Soldier"
	},
/obj/effect/lighting_dummy/yellowlight,
/obj/item/bombdefusal,
/obj/effect/landmark/start{
	name = "Red Engineer"
	},
/turf/unsimulated/floor/hammereditor/dev1,
/area/warfare/ctspawn)
"f" = (
/obj/effect/lighting_dummy/yellowlight,
/obj/structure/warfare/barricade/concrete_barrier{
	dir = 8
	},
/turf/unsimulated/floor/hammereditor/dev22,
/area/warfare/map)
"g" = (
/obj/effect/lighting_dummy/yellowlight,
/obj/structure/warfare/barricade/concrete_barrier{
	dir = 4
	},
/turf/unsimulated/floor/hammereditor/dev22,
/area/warfare/bombsite)
"j" = (
/obj/effect/lighting_dummy/yellowlight,
/turf/unsimulated/wall/hammereditor/dev2,
/area/warfare/bombsite)
"k" = (
/obj/effect/landmark/start{
	name = "Red Soldier"
	},
/obj/effect/lighting_dummy/yellowlight,
/obj/effect/landmark/start{
	name = "Red Engineer"
	},
/turf/unsimulated/floor/hammereditor/dev1,
/area/warfare/ctspawn)
"l" = (
/obj/effect/landmark/start{
	name = "Blue Soldier"
	},
/obj/item/plastique/keypad/blue/defuse,
/obj/effect/lighting_dummy/yellowlight,
/obj/effect/landmark/start{
	name = "Blue Engineer"
	},
/turf/unsimulated/floor/hammereditor/dev1,
/area/space)
"n" = (
/obj/effect/lighting_dummy/yellowlight,
/turf/unsimulated/floor/hammereditor/dev22,
/area/warfare/map)
"q" = (
/obj/effect/landmark/start{
	name = "Blue Soldier"
	},
/obj/effect/lighting_dummy/yellowlight,
/obj/effect/landmark/start{
	name = "Blue Engineer"
	},
/turf/unsimulated/floor/hammereditor/dev1,
/area/space)
"r" = (
/obj/effect/landmark/test/space_turf,
/obj/effect/lighting_dummy/yellowlight,
/turf/unsimulated/wall/hammereditor/dev2,
/area/warfare/map)
"u" = (
/obj/effect/landmark/map_data,
/obj/effect/lighting_dummy/yellowlight,
/turf/unsimulated/wall/hammereditor/dev2,
/area/warfare/map)
"v" = (
/obj/effect/lighting_dummy/yellowlight,
/turf/unsimulated/wall/hammereditor/dev3,
/area/warfare/map)
"w" = (
/obj/structure/ore_box,
/obj/effect/lighting_dummy/yellowlight,
/turf/unsimulated/floor/hammereditor/dev1,
/area/warfare/map)
"y" = (
/obj/effect/landmark/start{
	name = "Red Soldier"
	},
/obj/effect/lighting_dummy/yellowlight,
/obj/item/bombdefusal,
/obj/effect/landmark/start{
	name = "Red Engineer"
	},
/turf/unsimulated/floor/hammereditor/dev22,
/area/warfare/ctspawn)
"A" = (
/obj/effect/landmark/test/safe_turf,
/obj/effect/lighting_dummy/yellowlight,
/turf/unsimulated/wall/hammereditor/dev2,
/area/warfare/map)
"C" = (
/obj/effect/lighting_dummy/yellowlight,
/obj/structure/table/rack/shelf/red,
/obj/item/storage/fancy/cigarettes/carcinomas,
/obj/item/storage/fancy/cigarettes/carcinomas,
/obj/item/storage/fancy/cigarettes/jerichos,
/obj/item/flame/lighter/zippo,
/turf/unsimulated/floor/hammereditor/dev1,
/area/warfare/map)
"D" = (
/obj/effect/lighting_dummy/yellowlight,
/turf/unsimulated/wall/hammereditor/dev2,
/area/warfare/map)
"F" = (
/obj/effect/lighting_dummy/yellowlight,
/obj/machinery/door/unpowered/simple/interiorroom,
/turf/unsimulated/floor/hammereditor/dev1,
/area/warfare/map)
"G" = (
/obj/effect/lighting_dummy/yellowlight,
/turf/unsimulated/floor/hammereditor/dev22,
/area/warfare/bombsite)
"H" = (
/obj/effect/lighting_dummy/yellowlight,
/turf/unsimulated/wall/hammereditor/dev2,
/area/warfare)
"I" = (
/obj/effect/lighting_dummy/yellowlight,
/obj/machinery/telecomms/allinone{
	intercept = 1
	},
/turf/unsimulated/wall/hammereditor/dev2,
/area/warfare/map)
"L" = (
/obj/effect/lighting_dummy/yellowlight,
/obj/structure/statue/verina{
	density = 0;
	pixel_x = -16;
	pixel_y = 1
	},
/turf/unsimulated/floor/hammereditor/dev22,
/area/warfare/map)
"N" = (
/obj/effect/lighting_dummy/yellowlight,
/obj/structure/warfare/barricade/concrete_barrier{
	dir = 4
	},
/turf/unsimulated/floor/hammereditor/dev22,
/area/warfare/map)
"O" = (
/obj/effect/lighting_dummy/yellowlight,
/obj/structure/warfare/barricade/concrete_barrier,
/turf/unsimulated/floor/hammereditor/dev22,
/area/warfare/map)
"P" = (
/obj/effect/lighting_dummy/yellowlight,
/obj/structure/ore_box,
/turf/unsimulated/floor/hammereditor/dev1,
/area/warfare/map)
"T" = (
/obj/effect/landmark/start,
/obj/effect/lighting_dummy/yellowlight,
/turf/unsimulated/wall/hammereditor/dev2,
/area/warfare/map)
"U" = (
/obj/effect/landmark/start{
	name = "Blue Soldier"
	},
/obj/effect/lighting_dummy/yellowlight,
/obj/effect/landmark/start{
	name = "Blue Engineer"
	},
/turf/unsimulated/floor/hammereditor/dev22,
/area/space)
"V" = (
/obj/hammereditor/playerclip/defuse,
/obj/effect/lighting_dummy/yellowlight,
/turf/unsimulated/floor/hammereditor/dev12,
/area/warfare/map)
"W" = (
/obj/effect/landmark{
	name = "tdome1"
	},
/obj/effect/lighting_dummy/yellowlight,
/turf/unsimulated/floor/hammereditor/dev1,
/area/warfare/map)
"X" = (
/obj/effect/landmark{
	name = "JoinLate"
	},
/obj/effect/lighting_dummy/yellowlight,
/turf/unsimulated/floor/hammereditor/dev1,
/area/warfare/map)

(1,1,1) = {"
D
D
D
D
D
D
D
D
D
D
D
D
D
D
D
D
D
D
D
D
D
D
D
D
D
D
D
D
D
D
D
A
"}
(2,1,1) = {"
D
D
D
D
D
D
a
a
a
a
a
a
a
a
a
a
a
a
a
a
a
a
a
a
a
a
a
a
W
W
W
r
"}
(3,1,1) = {"
D
q
q
q
q
D
a
a
a
a
a
a
a
a
a
a
a
a
a
D
D
D
F
D
D
D
D
D
W
W
W
u
"}
(4,1,1) = {"
D
q
q
q
U
V
n
a
a
a
a
a
a
a
a
a
a
a
a
D
P
P
a
a
a
a
a
D
W
W
W
T
"}
(5,1,1) = {"
D
q
q
l
U
V
n
a
a
a
a
a
a
a
a
a
a
a
a
D
C
G
G
G
P
a
a
b
X
X
X
D
"}
(6,1,1) = {"
D
q
q
q
q
D
a
a
a
a
a
a
a
a
a
a
a
a
a
D
c
G
G
G
a
a
a
D
X
X
X
D
"}
(7,1,1) = {"
D
D
D
D
D
D
a
a
a
a
a
a
a
a
a
a
D
D
D
D
D
j
g
g
a
a
a
D
X
X
X
D
"}
(8,1,1) = {"
D
a
a
a
a
a
a
a
D
a
a
a
a
a
a
a
a
a
D
c
P
P
P
a
a
a
a
D
a
a
a
D
"}
(9,1,1) = {"
D
a
a
a
a
a
a
a
D
a
a
a
a
a
a
a
a
a
D
c
a
a
a
a
a
a
a
D
a
a
a
D
"}
(10,1,1) = {"
D
a
a
a
a
a
a
a
D
a
a
a
a
a
a
a
a
a
D
c
a
a
a
a
a
a
a
D
a
a
a
D
"}
(11,1,1) = {"
D
a
a
a
a
a
a
a
D
a
a
a
a
a
a
a
a
w
D
D
D
F
D
D
D
D
D
D
a
a
a
D
"}
(12,1,1) = {"
D
a
a
a
a
a
a
a
v
a
a
a
a
a
a
a
w
w
D
a
a
a
a
a
a
a
a
v
a
a
a
D
"}
(13,1,1) = {"
D
a
a
a
a
a
a
a
D
a
a
a
a
a
a
a
w
w
D
a
a
a
a
a
a
a
a
D
a
a
a
D
"}
(14,1,1) = {"
D
a
a
a
a
a
a
a
D
a
a
a
a
a
D
D
D
D
D
a
a
a
a
a
a
a
a
D
a
a
a
D
"}
(15,1,1) = {"
D
a
a
a
a
a
a
a
D
a
a
a
a
a
a
a
a
a
a
a
a
a
a
a
a
a
a
D
a
a
a
D
"}
(16,1,1) = {"
D
a
a
a
a
a
a
a
D
a
a
a
a
a
a
a
a
a
a
a
a
a
a
a
a
a
a
D
a
a
a
D
"}
(17,1,1) = {"
D
a
a
a
a
a
a
a
D
D
D
D
a
a
a
a
a
a
a
a
a
a
a
a
D
D
D
D
a
a
a
D
"}
(18,1,1) = {"
D
a
a
a
a
a
a
a
a
a
a
a
a
a
a
a
a
a
a
a
a
a
a
a
a
a
a
a
a
a
a
D
"}
(19,1,1) = {"
D
a
a
a
a
a
a
a
a
a
a
D
a
a
a
a
a
a
a
a
a
a
a
a
a
a
a
a
a
a
a
D
"}
(20,1,1) = {"
D
a
D
D
D
D
D
a
a
a
a
D
a
a
a
a
a
a
a
a
a
a
a
a
a
a
a
a
a
a
a
D
"}
(21,1,1) = {"
D
a
a
a
P
D
a
a
a
a
a
a
a
a
a
a
a
a
a
a
a
a
a
a
a
a
a
a
a
a
a
D
"}
(22,1,1) = {"
D
a
a
a
a
a
a
a
f
n
O
a
a
a
a
D
D
D
D
D
D
D
a
a
a
a
a
a
a
a
a
D
"}
(23,1,1) = {"
D
a
a
a
a
a
a
a
n
L
O
a
a
a
a
a
a
a
a
a
a
a
a
a
a
a
a
a
a
a
a
D
"}
(24,1,1) = {"
D
a
a
a
a
a
a
a
N
n
O
a
a
a
a
a
a
a
a
a
a
a
a
a
a
a
a
a
a
a
a
D
"}
(25,1,1) = {"
D
a
a
a
a
a
a
a
a
a
a
a
a
a
a
a
a
a
a
a
a
a
a
a
a
a
a
a
a
a
a
D
"}
(26,1,1) = {"
D
a
a
D
D
a
a
D
D
a
a
a
a
a
a
a
a
a
a
a
a
a
a
a
a
a
a
a
a
a
a
D
"}
(27,1,1) = {"
D
a
a
a
a
a
a
a
a
a
a
a
D
a
a
a
a
a
a
a
a
a
a
a
a
a
D
D
D
D
D
I
"}
(28,1,1) = {"
D
a
a
a
D
a
a
a
a
a
a
w
D
a
a
a
a
a
a
a
a
a
a
a
a
a
D
d
k
k
k
D
"}
(29,1,1) = {"
D
a
a
a
D
a
a
a
a
a
w
w
D
a
a
a
a
a
a
a
a
a
a
a
a
n
V
y
k
k
k
D
"}
(30,1,1) = {"
D
a
a
D
D
a
a
a
D
D
D
D
D
a
a
a
a
a
a
a
a
a
a
a
a
n
V
y
k
k
k
D
"}
(31,1,1) = {"
D
a
a
a
a
a
a
a
a
a
a
a
a
a
a
a
a
a
a
a
a
a
a
a
a
a
D
d
k
k
k
D
"}
(32,1,1) = {"
H
H
H
H
H
H
D
D
D
D
D
D
D
D
D
D
D
D
D
D
D
D
D
D
D
D
D
D
D
D
D
D
"}
